A.ADM1	политико-административное деление первого порядка	первоначальное политико-административное  деление, например, деление США на штаты
A.ADM1H	historical first-order administrative division	a former first-order administrative division
A.ADM2	политико-административное деление второго порядка	дальнейшее деление политико-административного деления первого порядка
A.ADM2H	historical second-order administrative division	a former second-order administrative division
A.ADM3	политико-административное деление третьего порядка	дальнейшее деление политико-административного деления второго порядка
A.ADM3H	historical third-order administrative division	a former third-order administrative division
A.ADM4	политико-административное деление четвертого порядка	дальнейшее деление политико-административного деления третьего порядка
A.ADM4H	historical fourth-order administrative division	a former fourth-order administrative division
A.ADM5	fifth-order administrative division	a subdivision of a fourth-order administrative division
A.ADM5H	historical fifth-order administrative division	a former fifth-order administrative division
A.ADMD	политико-административное  деление	деление страны на административные единицы
A.ADMDH	historical administrative division 	a former administrative division of a political entity, undifferentiated as to administrative level
A.LTER	арендованный район/территория	арендованный правительством Великобритании у властей Китая участок земли, часть Гонконга
A.PCL	политическое образование	
A.PCLD	зависимое политическое образование	
A.PCLF	свободно присоединившееся государство (свободное ассоциированное государство)	
A.PCLH	historical political entity	a former political entity
A.PCLI	независимое политическое образование	
A.PCLIX	участок независимого политического образования	
A.PCLS	наполовину зависимое политическое образование	
A.PRSH	церковный приход	низший церковный округ в христианской церкви, центром которого является храм
A.TERR	территория (административная единица в США, Канаде и Австралии, не имеющая прав штата или провинции)	
A.ZN	зона	
A.ZNB	буферная зона	область, официально признанная в качестве буфера между двумя нациями; военное присутствие минимально или вовсе отсутствует
H.AIRS	посадочная полоса для гидросамолета	место на воде для взлета и посадки гидросамолета
H.ANCH	якорная стоянка	место, где судна бросают якорь
H.BAY	бухта	изгиб берега  между двумя мысами, больше чем открытая гавань, но меньше чем залив
H.BAYS	бухты	изгибы берега  между двумя мысами, больше чем открытая гавань, но меньше чем залив
H.BGHT	излучина (реки)	открытый участок воды; там, где происходит отступание береговой черты
H.BNK	нанос	возвышенность, которая обычно располагается на мелководье; однако количества воды достаточно для надводного судоходства
H.BNKR	речной берег	косой берег реки, который удерживает поток воды в своих границах
H.BNKX	участок берега	
H.BOG	болото	заболоченная территория, которая является благоприятной почвой для торфяного мха, осоки и других болотных растений
H.CAPG	шапка полярного льда	куполообразная масса ледникового льда, покрывающая гонные вершины; по размеру меньше ледникового щита
H.CHN	русло	самый глубоки участок реки, пролива, залива, лагуны; через него проходит основной поток воды
H.CHNL	омут	наиболее глубокое место в озере; здесь могут проходить суда
H.CHNM	морской канал	канал, предназначенный для судоходной связи между морями
H.CHNN	судоходное русло	огражденный буями пролив, достаточно глубокий для безопасного судоходства
H.CNFL	место слияние (рек)	место, где две (или больше) реки соединяются в одну
H.CNL	канал	искусственная река
H.CNLA	акведук/водопровод	трубопровод, используемый для передачи воды
H.CNLB	излучина канала	изогнутый участок канала
H.CNLD	водоотводный канал	искусственный судоходный канал, забирает лишнюю воду  либо в заболоченной местности, либо из дренажного канала
H.CNLI	оросительный канал	канал, который служит главным средством передачи воды для орошения
H.CNLN	судоходный канал	канал, предназначенный для судоходства
H.CNLQ	заброшенный канал	
H.CNLSB	подземный оросительный канал	подземный туннель, по которому течет вода, используемая  для орошения; вода берется из водоносного слоя почвы
H.CNLX	сечение канала	
H.COVE	прибойная пещера	защищённое, закрытое место в скалах на морском берегу
H.CRKT	небольшой временный водоток (связанный с приливами и отливами)	извилистый канал на прибрежной заболоченной территории, по которому идет двустороннее приливное течение
H.CRNT	течение	горизонтальный поток воды в заданном направлении с одинаковой скоростью
H.CUTF	обводной канал	канал, образованный в результате потока воды, идущей  через шейку меандра
H.DCK	док	портовое сооружение для ремонта и постройки судов.
H.DCKB	портовый бассейн	часть гавани, предназначенная для стоянки судов
H.DOMG	ледниковый купол	небольшая возвышенность на поверхности ледника
H.DPRG	ледниковая впадина	небольшое углубление на поверхности ледника
H.DTCH	канава	небольшой искусственный водоем, используемый для осушения и орошения территории
H.DTCHD	водоотводная канава	канава, используемая для осушения территории
H.DTCHI	оросительная канава	канава, используемая для орошения почвы
H.DTCHM	устье канала	место, где осушительный канал впадает в лагуну, озеро или залив
H.ESTY	эстуарий	однорукавное, воронкообразное устье реки, расширяющееся в сторону моря
H.FISH	рыболовная зона	место ловли рыбы
H.FJD	фьорд	узкий, длинный, глубоководный морской залив с крутыми берегами; берега фьорда  в большинстве случаев образованы высокими скалами
H.FJDS	фьорды	узкие, длинные, глубоководные морские заливы с крутыми берегами
H.FLLS	водопад	падение воды в реке с уступа, пересекающего речное русло
H.FLLSX	участок водопада	
H.FLTM	топь	средних размеров площадь илистого грунта, занимает промежуточное место между высокой и низкой границами прилива, подвергается затоплению
H.FLTT	приливно-отливная отмель	береговая полоса, покрываемая водой при приливе
H.GLCR	ледник	масса льда преимущественно атмосферного происхождения, испытывающая вязкопластическое течение под действием силы тяжести и принявшая форму потока, системы потоков, купола (щита) или плавучей плиты
H.GULF	морской залив	вдавшаяся в сушу часть моря
H.GYSR	гейзер	источник вулканического происхождения, выбрасывающий через определённые промежутки времени фонтаны горячей воды и пара
H.HBR	гавань	естественная или искусственная защищенная от ветра и волн прибрежная часть водного пространства, служащая местом стоянки, причала и ремонта судов
H.HBRX	участок гавани	
H.INLT	узкий пролив	узкий водный путь, простирающийся до суши; или связывающий бухту или лагуну с большим водным образованием
H.INLTQ	засыпанный узкий пролив	узкий пролив, который ранее был пригоден для судоходства, в настоящее время пролив засыпан
H.LBED	озерная котловина	место, которое осталось после высохшего или специально осушенного озера
H.LGN	лагуна	мелководный залив или озеро, отделившиеся от моря вследствие образования песчаной полосы
H.LGNS	лагуны	мелководные заливы или озеро, отделившиеся от моря вследствие образования песчаной полосы
H.LGNX	участок лагуны	
H.LK	озеро	замкнутый естественный водоём в углублении суши, котловине
H.LKC	кратерное озеро	озеро в кратере или кальдере (круглое или овальное углубление в жерле вулкана)
H.LKI	временно исчезающее озеро	
H.LKN	соленое озеро	озеро, вода которого сильно минерализована; содержит большое количество солей
H.LKNI	временно исчезающее соленое озеро	
H.LKO	пойменное озеро	серповидное озеро, прилегающее  к извилистым рекам
H.LKOI	временно исчезающее пойменное озеро	
H.LKS	озера	замкнутые естественные водоёмы в углублении суши, котловине
H.LKSB	подземное озеро	озеро в карстовых пещерах, питающееся подземными водами
H.LKSC	кратерные озера	озера в кратере или кальдере (круглое или овальное углубление в жерле вулкана)
H.LKSI	исчезающие озера	
H.LKSN	соленые озера	озера, вода которых сильно минерализована; содержит большое количество солей
H.LKSNI	исчезающие соленые озера	
H.LKX	участок озера	
H.MFGN	соленый испарительный пруд	обвалованный соленые пруды, используемые в производстве  выварочной соли
H.MGV	мангровое болото	связанная с приливами и отливами, тропическая, илистая, равнинная местность, на которой произрастают мангровые растения
H.MOOR	торфяник	залежи торфа, торфяное болото
H.MRSH	травяное болото	заболоченная территория, заросшая травой
H.MRSHN	соленое травяное болото	равнинная местность, подверженная затоплению соленой водой; здесь произрастают преимущественно травянистые солеустойчивые растения
H.NRWS	узкости	район водной поверхности, доступный для плавания по ширине и по глубинам, но стесняющий свободное маневрирование из-за близости берегов, рифов, отмелей и кос
H.OCN	океан	непрерывная водная оболочка Земли, окружающая материки и острова и обладающая общностью солевого состава
H.OVF	водоворот	круговращательное движение воды, происходящее от столкновения встречных течений
H.PND	пруд	небольшой водоем со стоячей водой
H.PNDI	временно исчезающий пруд	
H.PNDN	соленый пруд	небольшой водоем с соленой водой, обычно в болотистой местности, или вдоль морского побережья
H.PNDNI	временно исчезающий соленый пруд	
H.PNDS	пруды	небольшие водоемы со стоячей водой
H.PNDSF	пруд для разведения рыб	специальный искусственный водоем, в котором разводят рыб
H.PNDSI	временно исчезающие пруды	
H.PNDSN	соленые пруды	небольшие водоемы с соленой водой, обычно в болотистой местности, или вдоль морского побережья
H.POOL	бассейн	водоем со стоячей водой
H.POOLI	временно исчезающий водоем	
H.RCH	плёс	участок реки между изгибами, перекатами с широким, спокойным течением и большей, чем на перекатах, глубиной
H.RDGG	шапка полярного льда	узкая и длинная возвышенность на ледниковой поверхности
H.RDST	рейд	часть акватории порта, предназначенная для якорной стоянки судов и перегрузки грузов
H.RF	риф(ы)	резкое надводное или подводное возвышение морского дна на мелководьях, препятствующее судоходству
H.RFC	коралловые рифы	подводные геологические образования из органогенных известняков, представляющие собой препятствия (опасности) для навигации
H.RFX	участок риф	
H.RPDS	пороги реки	мелководный каменистый или скалистый участок в русле реки с относительно большим падением уровня воды и повышенной скоростью течения
H.RSV	водохранилище	искусственный водоём, образованный, как правило, в долине реки водоподпорными сооружениями для накопления и хранения воды в целях её использования в народном хозяйстве
H.RSVI	периодически пересыхающее водохранилище	
H.RSVT	водяной бак	наполненный водой бак или резервуар, находящийся на, выше или ниже уровня земли
H.RVN	овраг	глубокая длинная впадина на поверхности земли, образовавшаяся от действия дождевых и талых вод
H.SBKH	себха	замкнутое бессточное понижение рельефа с плоским глинистым днищем, занятым солончаками
H.SD	широкая лагуна	длинный морской рукав, образующий пролив между материком и островом, или островами
H.SEA	море	большое водное пространство, ограниченное с одной или нескольких сторон сушей и отделяемое от самого океана островами или возвышенностями подводного рельефа
H.SHOL	мелководье	участок (обычно прибрежный) реки, озера и т.п. с небольшой глубиной
H.SILL	подводный хребет	вытянутое горное поднятие на дне океанов и морей. Часто подводные хребты выступают над поверхностью воды в виде островов или целых архипелагов
H.SPNG	родник	водный источник, бьющий, текущий из глубины земли; ключ
H.SPNS	серный источник	источник воды, насыщенной сероводородом
H.SPNT	термальный источник	источник термальных вод, температура которых выше 20°C
H.STM	ручей	небольшой мелкий водоток с постоянным или временным течением
H.STMA	протока	водоток, отходящий от реки и впадающий в неё ниже по течению;
H.STMB	излучина ручья	крутой поворот, изгиб ручья
H.STMC	водоток канала	естественный или искусственный водный поток канала
H.STMD	рукав реки	ответвление, отходящее от главного русла реки
H.STMH	верховье	часть реки, близкая к её истокам; прилегающая к ней местность
H.STMI	река с периодическим водотоком	
H.STMIX	участок реки с периодическим водотоком	
H.STMM	устье реки	место впадения реки (в море, озеро и т.п.), конечный участок нижнего течения реки
H.STMQ	высохший водоем	водоем, в котором больше нет воды, но который еще заметный благодаря его топографическим или растительным особенностям
H.STMS	ручьи	небольшие мелкие водотоки с постоянным или временным течением
H.STMSB	высохшая река	река,  полностью высохшая или превратившаяся в подземный канал
H.STMX	участок ручья	
H.STRT	пролив	узкое водное пространство, разъединяющее участки суши и соединяющее водоёмы (моря, озёра и т.п.) или их части
H.SWMP	лесное болото	заболоченная территория, на которой преобладает древесная растительность
H.SYSI	оросительная система	земельная территория вместе с сетью каналов и др. гидротехнических и эксплуатационных сооружений, обеспечивающих её орошение
H.TNLC	судоходный тоннель	тоннель, сооружаемый при пересечении судоходным каналом возвышенности, горного хребта и т. п.
H.WAD	вади	русло или долина пересыхающего водотока; в Азии, в Африке
H.WADB	излучина вади	изогнутый участок вади
H.WADJ	место слияния двух или более вади	a place where two or more wadies join
H.WADM	устье вади	место впадения вади (в море, озеро и т.п.), конечный участок нижнего течения вади
H.WADS	множество вади	русла или долины пересыхающих водотоков; в Азии, в Африке
H.WADX	участок вади	
H.WHRL	водоворот	вращательное движение воды в реках, морях и т.п.; место, где происходит такое движение
H.WLL	колодец	глубокая яма с отвесными стенками, обычно защищённая от обвалов срубом, служащая для добывания воды из водоносных слоёв земли
H.WLLQ	заброшенный колодец	
H.WLLS	колодцы	глубокие ямы с отвесными стенками, обычно защищённые от обвалов срубом, служащие для добывания воды из водоносных слоёв земли
H.WTLD	заболоченная местность	территория, подвергающаяся частым наводнениям; здесь часто образуются болота, на которых растет характерная для них болотная растительность
H.WTLDI	периодически затопляемая территория	
H.WTRC	поток	стремительно текущая река или ручей
H.WTRH	водяная яма	естественное углубление, в котором собирается вода
L.AGRC	сельскохозяйственная колония	участок земли, отведенный для сельскохозяйственных поселений
L.AMUS	Парк аттракционов  (ПКиО)	парк развлечений, то же, что и ярмарка, только с постоянным месторасположением
L.AREA	Область	местность, земля, край; часть какой-либо территории (страны, государства, материка, земной суши и т.п.), выделяемая при районировании по определённому существенному признаку
L.BSND	Водосборный бассейн	поверхность, с которой речная система, море или озеро собирают воды
L.BSNP	нефтегазовый бассейн	область с богатой нефтью структурной впадиной
L.BTL	поле боя	район боевых действий; имеет важное историческое значение
L.CLG	поляна	открытое пространство в парке или в лесу
L.CMN	общинные земли	земли (выгоны, сенокосы, леса), которые  находятся в общем пользовании
L.CNS	лицензионная территория	арендуемая государством земля, пользование которой необходимо для экономического развития, например, шахты, лесные массивы
L.COLF	угольный бассейн	площадь непрерывного или островного распространения угленосных формаций, значительная по размерам или запасам угля
L.CONT	континент	континент: Евразия, Африка, Северная Америка, Южная Америка, Антарктида, Австралия, Океания
L.CST	морской берег	полоса суши, примыкающая к водной поверхности моря или океана и взаимодействующая с ним
L.CTRB	бизнес центр	деловая часть города
L.DEVH	квартал	часть застроенной территории населенного пункта, предполагающая целостность архитектурного замысла
L.FLD	поле	безлесная равнина, ровное (в отличие от селения, леса) обширное пространство
L.FLDI	ирригационные поля	участки земли, подготовленные для естественной биологической очистки сточных вод и выращивания с.-х. растений
L.GASF	месторождение газа	совокупность залежей природного газа на определенной территории
L.GRAZ	пастбище	участок травянистой растительности, используемый и поддерживаемый для выпаса домашних животных
L.GVL	покрытие из гравия	покрытая гравием территория
L.INDS	промышленный район	территория с ярко выраженной индустриально-производственной специализацией
L.LAND	арктические земли	участок земли в Арктике
L.LCTY	район	название низовой административно-территориальной единицы
L.MILB	военная база	территория (важный в стратегическом или политическом отношении пункт, район) и размещенные на ней войска с запасами оружия, боеприпасов, продовольствия и других материальных средств, необходимых для боевой и повседневной деятельности
L.MNA	район разработки	район добычи полезных ископаемых
L.MVA	полигон	участок суши или моря, предназначенный для испытаний различных видов оружия, боевых средств и техники, а также для боевой подготовки войск
L.NVB	военно-морская база	оборудованный и обороняемый район (зона) побережья и прилегающего участка моря обычно с несколькими пунктами базирования кораблей, с силами и средствами, предназначенными для обороны
L.OAS	оазис	участок пустыни или полупустыни с обильным естественным или искусственным увлажнением, обусловленным близостью рек и грунтовых вод, и с богатой растительностью
L.OILF	нефтяное месторождение	место под землей, где залегают запасы нефти
L.PEAT	торфяное месторождение	место, где добывают торф
L.PRK	парк	обширная озелененная территория, благоустроенная и художественно оформленная для отдыха под открытым небом
L.PRT	порт	место с закрытым водным пространством, специально оборудованное для стоянки, погрузки и разгрузки судов, гавань
L.QCKS	зыбучие пески	пески, перенасыщенные водой восходящих источников и способные вследствие этого засасывать попадающие на них предметы, животных и человека
L.RES	заповедник	особо охраняемая территория, полностью исключенная из любой хозяйственной деятельности в целях сохранения в нетронутом виде природных комплексов
L.RESA	агрозаповедник	участок земли, предназначенный для агромелиорации
L.RESF	лесной заповедник	особо охраняемый участок леса, использование которого контролируется
L.RESH	заповедно-охотничье хозяйство	участок территории, выделенный для интенсивного воспроизводства дичи и проведения строго регулируемых охот
L.RESN	особо охраняемая природная  территория	особо охраняемые участки земли, водной поверхности и воздушного пространства над ними, где располагаются природные комплексы и объекты, которые имеют свое научное, культурное, эстетическое и оздоровительное значение, которые изъяты решениями органов государственной власти полностью или частично из хозяйственного использования
L.RESP	пальмовый заповедник	место, где растут пальмы, использование которых контролируется
L.RESV	резервация	территории, отведенные для поселения коренного населения страны
L.RESW	резерват	заповедник, территория, где природные богатства (животные и растения) находятся под особой охраной правительства
L.RGN	регион	область, район, территория, часть страны, отличающиеся совокупностью естественных или исторически сложившихся экономико-географических условий и национального состава населения
L.RGNE	экономический регион	регион страны, характеризующийся своеобразием природных и экономических условий; деление страны на эк. регионы используется для получения статистических данных
L.RGNH	historical region	a former historic area distinguished by one or more observable physical or cultural characteristics
L.RGNL	озерный край	место скопления большого количества озер
L.RNGA	артиллерийский полигон	участок земли, где проходят военные артиллерийские учения
L.SALT	солевой бассейн	мелководье или равнинная местность, где после периодических наводнений собирается соль
L.SNOW	ледник	место скопления многолетнего снега и льда
L.TRB	территория племени	участок земли, являющийся в течение некоторого времени местом жительства для кочующих племен
NULL	недоступно	недоступно
P.PPL	населенный пункт	место, где живут люди (город, село, поселок и т. п.)
P.PPLA	центр административного деления первого порядка	центр административного деления первого порядка (столица политического образования предшествует центру АТД первого порядка)
P.PPLA2	центр административного деления второго порядка	
P.PPLA3	центр административного деления третьего порядка	
P.PPLA4	центр административного деления четвертого порядка	
P.PPLC	столица политического образования	
P.PPLCH	historical capital of a political entity	a former capital of a political entity
P.PPLF	деревня	населенный пункт, где большая часть населения занята в сельским хозяйством
P.PPLG	здание правительства политического образования	
P.PPLH	historical populated place	a populated place that no longer exists
P.PPLL	населенный пункт	первичная единица расселения людей в пределах одного застроенного земельного участка: город, поселок городского типа, село. Обязательным признаком населенного пункта является постоянство его использования как места обитания
P.PPLQ	покинутый населенный пункт	
P.PPLR	религиозная община	населенный пункт, где большую часть населения составляют люди, объединенные одной верой. Например, монастырь
P.PPLS	населенные пункты	первичные единицы расселения людей в пределах одного застроенного земельного участка: город, поселок городского типа, село. Обязательным признаком населенных пункт является постоянство его использования как места обитания.
P.PPLW	разрушенный населенный пункт	населенный пункт (деревня, город), пострадавший в результате природной катастрофы или войны
P.PPLX	участок населенного пункта	
P.STLMT	еврейские поселения	
R.CSWY	гать	насыпная дорога для проезда, прохода через топкое место
R.OILP	нефтепровод	трубопровод для перекачки нефти и нефтепродуктов
R.PRMN	променад	место для прогулки, особ. набережная, проспект, бульвар, аллея, палуба корабля
R.PTGE	волок	перевал в верховьях рек различных бассейнов
R.RD	дорога	полоса земли, служащая для езды и ходьбы
R.RDA	старая дорога	развалины, на месте которых была дорога во времена античности
R.RDB	поворот дороги	изогнутый участок дороги
R.RDCUT	выемка грунта под дорогу	вырытый в горном хребте туннель, через который будет проведена дорога
R.RDJCT	перекресток	место пересечения двух или более дорог
R.RJCT	железнодорожный узел	пункт на пересечении нескольких ж.-д. линий, представляющий собой сложный комплекс разнообразных технических сооружений и устройств
R.RR	железная дорога	рельсовый путь, предназначенный для движения поездов
R.RRQ	заброшенная железная дорога	
R.RTE	караванный путь	маршрут следования караванов
R.RYD	сортировочная станция	техническая железнодорожная станция для расформирования и формирования различных категорий поездов, выполнение техническое обслуживание и коммерческий осмотр составов поездов и устранение выявленных неисправностей вагонов, смена локомотивов и локомотивных бригад
R.ST	улица	пространство между двумя рядами домов в населенных пунктах для проезда и прохода
R.STKR	скотопрогон	маршрут перегона крупного рогатого домашнего скота
R.TNL	туннель	подземное сооружение, служащее для транспортных целей
R.TNLN	природный туннель	пещера, открытая с двух концов
R.TNLRD	автодорожный туннель	тоннель, через который проходит дорога
R.TNLRR	железнодорожный туннель	тоннель, по которому проходит ж/д дорога
R.TNLS	туннели	подземные  сооружение, служащие для транспортных целей
R.TRL	тропинка	узкая пешеходная дорожка, протоптанная людьми или животными в лесу, в поле, по снегу и т. п.
S.ADMF	администрация	Исполнительные и распорядительные органы управления, власти в государстве.
S.AGRF	агробаза	здание или участок земли, используемый для повышения качества сельскохозяйственной продукции
S.AIRB	авиабаза	земельный (водный) участок, предназначенный для базирования самолётов стратегической, тактической и транспортной авиации, вертолётов, частей обеспечения, ремонта, запасов материальных и технических средств обеспечения боевых действий
S.AIRF	аэродром	комплекс сооружений, оборудования и земельный участок с воздушным пространством, предназначенный для взлёта, посадки, размещения и обслуживания самолётов
S.AIRH	вертолетная площадка	земельный участок, площадка на здании, судне и т.п., оборудованные для взлёта, посадки и обслуживания вертолётов
S.AIRP	аэропорт	комплекс сооружений (с аэродромом и аэровокзалом) для осуществления регулярных полётов транспортной авиации и обслуживания пассажиров
S.AIRQ	заброшенный аэродром	
S.AMTH	амфитеатр	декоративное сооружение в форме эллипса со ступенчато расположенными рядами сидений, предназначенное для зрелищных мероприятий
S.ANS	городище	остатки древнего укрепленного поселения или города
S.AQC	aquaculture facility	facility or area for the cultivation of aquatic animals and plants, especially fish, shellfish, and seaweed, in natural or controlled marine or freshwater environments; underwater agriculture
S.ARCH	арка	декоративное сооружение в виде больших ворот со сводом
S.ASTR	обсерватория	научное учреждение, ведущее астрономические и геофизические наблюдения и исследования; здание, специально оборудованное для таких наблюдений
S.ASYL	убежище	место, где можно укрыться, скрыться от чего-н.
S.ATHF	стадион	комплексное спортивное сооружение со специально оборудованными площадками для состязаний, тренировок, вспомогательными помещениями и трибунами для зрителей
S.ATM	банкомат	автоматическое устройство, предназначенное для получения наличных денег по кредитной карточке.
S.BANK	банк	особые экономические институты, осуществляющие: аккумуляцию денежных средств и накоплений, предоставление кредита, проведение денежных расчётов, выпуск в обращение определённых видов денег
S.BCN	маяк	устройство, оборудованное звуковой, световой или радиотехнической сигнализацией для навигационного ориентирования судов, самолетов и т.п.
S.BDG	мост	сооружение для перехода, переезда через реку, овраг, железнодорожный путь и т.п.
S.BDGQ	разрушенный мост	мост, который больше не функционирует
S.BLDG	здание	архитектурное сооружение, постройка (обычно больших размеров), например, дом, завод и т.п.
S.BLDO	office building	commercial building where business and/or services are conducted
S.BP	межевой знак	ограничительный знак, используемый для обозначения границ
S.BRKS	бараки	шалаши, временные, легкие строения для размещения войск или рабочих
S.BRKW	волнорез	гидротехническое сооружение для защиты места стоянки судов или берега от разрушительного действия волн
S.BSTN	прессовальная станция	место, где прессуют сено в тюки
S.BTYD	лодочная мастерская	расположенное на берегу моря, реки и т.п.  сооружение, которое занимается обслуживанием, ремонтом и изготовлением лодок
S.BUR	могила	яма для погребения умершего
S.BUSTN	автостанция	транспортное предприятие для обслуживания пассажиров междугородных и пригородных автобусных сообщений
S.BUSTP	автобусная остановка	пункт, место, установленные для посадки и высадки пассажиров
S.CARN	пирамида из камней	груда камней, служащая условным знаком, надгробным памятником и т.п.
S.CAVE	пещера	углубление, полое пространство, образовавшееся в земной коре, горных массивах естественным путём или созданные человеком, с выходом наружу
S.CH	церковь	здание, в котором происходит христианское богослужение
S.CMP	лагерь	временное поселение, стоянка
S.CMPL	лесной поселок	временное поселение лесозаготовителей
S.CMPLA	лагерь сезонных рабочих	лагерь, в котором живут трудовые мигранты, приезжающие на заработки
S.CMPMN	рудничный поселок	временное поселение горняков
S.CMPO	поселок нефтяников	поселок, в котором живут работники нефтяной промышленности
S.CMPQ	покинутый лагерь/поселок	
S.CMPRF	лагерь беженцев	лагерь, в котором живут беженцы (люди, покинувшие место своего жительства, спасаясь от бедствия (землетрясения, войны, голода и т.п.)
S.CMTY	кладбище	место, предназначенное для погребения умерших
S.COMC	узел связи	совокупность технических средств оператора связи, обеспечивающих оказание услуг связи и присоединение к сети общего пользования
S.CRRL	корраль	загон для скота
S.CSNO	казино	игорный дом, в котором осуществляется проведение азартных игр
S.CSTL	замок	здание (или комплекс зданий), сочетающие в себе жилые и оборонительно функции
S.CSTM	таможня	помещение, где размещается учреждение, ведающее контролем провоза через границу грузов, багажа, почты и собирающее пошлину за такой провоз
S.CTHSE	здание суда	здание, в котором проходят заседания суда
S.CTRA	центр атомных исследований	научный центр, в котором проводятся атомные исследования
S.CTRCM	дом культуры	помещение для проведения культурных и общественных мероприятий
S.CTRF	центр обслуживания	центр, предоставляющий не одну, а сразу несколько услуг одновременно
S.CTRM	медицинский центр	комплекс лечебных учреждений; включает в себя: больницу, поликлинику, аптеку, медицинский институт
S.CTRR	религиозный центр	комплекс нескольких религиозных учреждений (монашеская обитель, школа для священнослужителей, церковь)
S.CTRS	космический центр	центр, который осуществляет запуск и наблюдение за полетом искусственных спутников земли и космических кораблей
S.CVNT	женский монастырь	обитель, общежитие монахинь
S.DAM	дамба	гидротехническое сооружение, искусственная насыпь для предохранения местности от затопления, для ограждения водохранилищ и т.п.
S.DAMQ	разрушенная дамба	дамба, которая больше не функционирует
S.DAMSB	грунтовая дамба	дамба, возведенная на  песчаном дне реки
S.DARY	молочный комбинат	предприятие по производству молочных продуктов
S.DCKD	сухой док	портовое сооружение для ремонта и постройки судов; сухой док сооружается на защищённой от волнения акватории и представляет собой отделяемую от неё с торца затвором водонепроницаемую камеру
S.DCKY	верфь	предприятие для постройки и ремонта судов
S.DIKE	канава	неглубокий и неширокий ров, обычно служащий для спуска или отвода воды
S.DIP	diplomatic facility	office, residence, or facility of a foreign government, which may include an embassy, consulate, chancery, office of charge d'affaires, or other diplomatic, economic, military, or cultural mission
S.DPOF	склад горючего	специальное помещение, предназначенное для хранения горючего
S.EST	поместье	крупное земельное владение, обычно с усадьбой
S.ESTO	плантация масличных пальм	большая земельная площадь, на которой выращивают масличные пальмы
S.ESTR	каучуковая плантация	большая земельная площадь, на которой выращивают каучуковые деревья
S.ESTSG	сахарная плантация	большая земельная площадь, на которой выращивают сахарный тростник
S.ESTT	чайная плантация	большая земельная площадь, на которой выращивают чай
S.ESTX	участок плантации	
S.FCL	учреждение	организация, образуемая для осуществления определённого рода деятельности (Государственное у. Общественные учреждения. Научные учреждения. Торговое, лечебно-профилактическое, административное у.)
S.FNDY	литейный цех	мастерская, в которой происходит обработка металла путем плавления и заливки в литейные формы
S.FRM	ферма	частное сельскохозяйственное предприятие, принадлежащее фермеру и ведущееся им на собственной или арендованной земле
S.FRMQ	покинутая (заброшенная) ферма	
S.FRMS	фермы	частные сельскохозяйственные предприятия, принадлежащие фермеру и ведущиеся им на собственной или арендованной земле
S.FRMT	усадьба	жилой дом с примыкающими надворными постройками и угодьями (сад, огород и т.п.), представляющий собой отдельное хозяйство (преимущественно в сельской местности)
S.FT	крепость	защитное сооружение или земляное укрепление
S.FY	паром	плоскодонное судно, плот для переправы людей, транспорта, грузов через реку, озеро или пролив
S.GATE	ворота	конструкция для регулирования входа и выхода
S.GDN	сад	участок земли для выращивания садовых растений
S.GHAT	ghat	a set of steps leading to a river, which are of religious significance, and at their base is usually a platform for bathing
S.GHSE	гостиница	дом с меблированными комнатами («номерами») для временного проживания путешественников
S.GOSP	нефтегазовый сепаратор	аппарат для отделения газа от нефти
S.GOVL	local government office	a facility housing local governmental offices, usually a city, town, or village hall
S.GRVE	могила	место захоронения
S.HERM	скит	жилище монахов-отшельников
S.HLT	место привала	место, где караваны останавливаются, чтобы передохнуть
S.HMSD	homestead	a residence, owner's or manager's, on a sheep or cattle station, woolshed, outcamp, or Aboriginal outstation, specific to Australia and New Zealand 
S.HSE	дом	жилое здание, строение
S.HSEC	загородный дом	дом, находящийся за городом, вне города, вблизи от него
S.HSP	госпиталь	лечебное учреждение, больница
S.HSPC	поликлиника	медицинское учреждение, осуществляющее внебольничное лечебно-профилактическое обслуживание населения
S.HSPD	диспансер	медицинское учреждение, занимающееся лечением и предупреждением болезней путём систематического врачебного наблюдения
S.HSPL	лепрозорий	приют для прокаженных
S.HSTS	исторический памятник	здания, сооружения, памятные места и предметы, связанные с важнейшими историческими событиями, жизнью исторических деятелей и т.п.
S.HTL	отель	то же, что и гостиница; дом для временного проживания туристов
S.HUT	хижина	небольшой примитивный домик
S.HUTS	хижины	небольшие примитивные домики
S.INSM	военная база	территория (важный в стратегическом или политическом отношении пункт, район) и размещенные на ней войска с запасами оружия, боеприпасов, продовольствия и других материальных средств, необходимых для боевой и повседневной деятельности
S.ITTR	научно-исследовательский институт	учреждение, занимающееся исследованиями
S.JTY	плотина	гидротехническое сооружение, перегораживающее реку (или др. водоток) для подъёма уровня воды перед ним, сосредоточения напора в месте расположения сооружения и создания водохранилища
S.LDNG	причал	совокупность сооружений и устройств для стоянки и обслуживания судов, посадки и высадки пассажиров, грузовых операций и т.п.
S.LEPC	приют для прокаженных	лечебное учреждение для больных проказой; место проживания и лечения таких больных
S.LIBR	библиотека	учреждение или отдел какого-л. учреждения, собирающие и хранящие книги, периодику, памятники письменности и т.п. для общественного пользования
S.LNDF	свалка	место, куда свозят, выбрасывают мусор, нечистоты, негодные вещи
S.LOCK	шлюз	гидротехническое сооружение между водоёмами с различными уровнями воды, позволяющее переводить суда из одного водоёма в другой
S.LTHSE	световой маяк	сооружение башенного типа, служащее ориентиром для опознавания берегов, определения места судна и предупреждения о навигационной опасности
S.MALL	торговый центр	группа разнородных торговых предприятий, сосредоточенных в одном месте, функционирующих и управляемых как единый, целостный объект
S.MAR	пристань	специально оборудованное место, сооружение для причаливания и стоянки лодок, яхт и т.д.
S.MFG	завод	промышленное или крупное промысловое предприятие, или комплекс предприятий
S.MFGB	пивоварня	предприятие по производству пива
S.MFGC	консервный завод	предприятие по производству консерв
S.MFGCU	медеплавильный завод	предприятие по переработке медной руды
S.MFGLM	известеобжигательная печь	печь для обжига извести
S.MFGM	оружейный завод	предприятие по производству оружия
S.MFGPH	фосфатный завод	предприятие по производству удобрений
S.MFGQ	покинутый завод	
S.MFGSG	рафинадный завод	завод по переработки сахарного тростника в рафинад
S.MKT	рынок	место торговли, на котором встречаются продавцы и покупатели
S.ML	фабрика	промышленное предприятие, обрабатывающее сырье машинным способом
S.MLM	завод по переработке руды	предприятие, которое занимается отделением друг от друга входящих в состав руды металлов
S.MLO	завод по производству оливкового масла	предприятие, которое занимается переработкой оливок и получением из них оливкового масла.
S.MLSG	сахарный завод	предприятие, которое занимается переработкой сахарного тростника в нерафинированный сахар
S.MLSGQ	бывший сахарный завод	сахарный завод, прекративший свою работу
S.MLSW	лесопильный завод	изготовление пиломатериалов (брусьев и досок) из брёвен
S.MLWND	ветряная мельница	аэродинамический механизм, который выполняет механическую работу за счет энергии ветра, улавливаемой крыльями мельницы. Наиболее известным применением ветряных мельниц является их использование для помола муки
S.MLWTR	водяная мельница	гидротехнические сооружение, использующее гидроэнергию, получаемую с водяного колеса, движение которого выполняет полезную работу посредством зубчатой передачи
S.MN	шахта	горнопромышленное предприятие, ведущее добычу полезных ископаемых подземным способом; место проведения подземных работ
S.MNAU	золотопромышленный рудник	предприятие, осуществляющее добычу золота или золотой руды
S.MNC	угольная шахта	горнопромышленное предприятие, ведущее добычу угля подземным способом
S.MNCR	шахта по добыче хрома	горнопромышленное предприятие, ведущее добычу хрома подземным способом
S.MNCU	медный рудник	горнопромышленное предприятие, осуществляющее добычу меди
S.MNFE	железный рудник	горнопромышленное предприятие, осуществляющее добычу железа
S.MNMT	памятник	архитектурное или скульптурное сооружение в память какого-л. лица, события
S.MNN	соляная шахта	горнопромышленное предприятие, осуществляющее добычу солей
S.MNQ	заброшенная шахта	
S.MNQR	карьер	место открытой разработки неглубоко залегающих полезных ископаемых (угля, песка, глины и т.п.)
S.MOLE	волнолом	гидротехническое сооружение для защиты места стоянки судов или берега от разрушительного действия волн
S.MSQE	мечеть	у мусульман: молитвенный дом
S.MSSN	резиденция миссионеров	жилые дома, больница, школа, принадлежащие религиозной организации, которая занимается благотворительностью и распространением собственной религии среди инаковерующих
S.MSSNQ	заброшенная резиденция миссионеров	
S.MSTY	мужской монастырь	религиозная община монахов, представляющая собой церковно-хозяйственную организацию, владеющую землями и капиталами
S.MTRO	станция метро	пункт остановки электропоездов в  метрополитене
S.MUS	музей	учреждение, собирающее, хранящее и выставляющее на обозрение памятники истории, искусства, культуры, науки, техники и других областей, сфер деятельности общества; помещение такого учреждения
S.NOV	дом послушничества	религиозный дом, где учатся послушники, готовящиеся стать монахами
S.NSY	теплица	тёплое с покрытием из прозрачного материала помещение для выращивания ранних овощей, цветов, теплолюбивых растений; оранжерея
S.OBPT	наблюдательный пункт	специально оборудованное место, с которого ведётся наблюдение за действиями противника и своих войск
S.OBS	обсерватория	научное учреждение, ведущее астрономические и геофизические наблюдения и исследования; здание, специально оборудованное для таких наблюдений
S.OBSR	радиообсерватория	учреждение, оборудованное антеннами для приема радиоволн из Космоса
S.OILJ	место соединение нескольких нефтепроводов	участок нефтепровода, на котором происходит соединение двух или более трубопроводов
S.OILQ	заброшенная нефтяная скважина	
S.OILR	нефтеперерабатывающий завод	предприятие, которое занимается переработкой нефти в бензин, авиационный керосин, мазут, дизельное топливо, смазочные масла, смазки, битумы, нефтяной кокс сырьё для нефтехимии
S.OILT	нефтехранилище	промышленный объект для хранения нефти или нефтепродуктов
S.OILW	нефтяная скважина	вертикальная горная выработка круглого сечения, предназначенная для разведки либо добычи нефти и попутного газа
S.OPRA	оперный дом	театр; оперная труппа театра
S.PAL	дворец	здание, являющееся жилищем, постоянным местопребыванием царствующей особы, главы государства, а также членов царствующей семьи
S.PGDA	пагода	в Китае, Японии и некоторых других странах: культовое мемориальное буддийское сооружение
S.PIER	пирс	двусторонний причал, выдающийся в акваторию порта и предназначенный для швартовки судов с двух сторон
S.PKLT	автостоянка	место для парковки автотранспорта
S.PMPO	нефтеперекачивающая станция	станция, предназначенная для перекачки нефти через трубопроводы
S.PMPW	водокачка	специальное здание для насосов, перекачивающих воду из водоёма к местам её использования
S.PO	почта	учреждение связи, ведающее пересылкой писем, периодических изданий, посылок, денег и т.п.; здание, помещение, где находится это учреждение
S.PP	милицейский пост	здание, в котором располагается пост милиции
S.PPQ	заброшенный полицейский пост	
S.PRKGT	ворота парка	вход в парк, запираемый створами
S.PRKHQ	администрация парка	здание, в котором располагается администрация парка
S.PRN	тюрьма	место заключения, здание, где содержатся лица, приговорённые судом к лишению свободы; лица, находящиеся под следствием
S.PRNJ	колония для несовершеннолетних	исправительно-трудовое учреждение, в котором отбывают наказание лица до 18 лет, осуждённые к лишению свободы
S.PRNQ	заброшенная тюрьма	
S.PS	электростанция	предприятие, где производится электроэнергия из других видов энергии
S.PSH	гидроэлектростанция	электростанция, преобразующая энергию падающей воды в электроэнергию (сокращённо ГЭС)
S.PSTB	пограничный пост	пост, ведающий контролем  передвижения через международную границу людей и товаров
S.PSTC	таможенный пост	пост, ведающий контролем провоза через границу грузов, багажа, почты и собирающее пошлину за такой провоз
S.PSTP	патрульный пост	вид наряда, который используется для несения патрульно-постовой службы
S.PYR	пирамида	В Древнем Египте: массивное сооружение из каменных блоков с четырёхугольным основанием и сходящимися к вершине боковыми гранями, служившее гробницей фараона
S.PYRS	пирамиды	В Древнем Египте: массивные сооружения из каменных блоков с четырёхугольным основанием и сходящимися к вершине боковыми гранями, служившие гробницей фараона
S.QUAY	причал	стоянка для судов; специальное сооружение, к которому причаливают суда
S.RDCR	traffic circle	a road junction formed around a central circle about which traffic moves in one direction only
S.RECG	поле для гольфа	место для отдыха, где находится поле, предназначенное для игры в гольф
S.RECR	ипподром	специально оборудованный участок для конных бегов, скачек и состязаний, представляющий собой площадь овальной формы с амфитеатром для зрителей
S.REST	ресторан	торговое заведение, где можно вкусно поесть и приятно провести время (иногда с музыкой, танцами и т.п.)
S.RET	store	a building where goods and/or services are offered for sale
S.RHSE	дом отдыха	лечебно-профилактическое учреждение для лечения и отдыха
S.RKRY	лежбище	место, где лежат стадами некоторые морские животные
S.RLG	религиозная святыня	место религиозного поклонения
S.RLGR	приют	жилище, где кто-л. чувствует себя безопасно, уютно и спокойно; пристанище, прибежище для бездомных или одиноких, нуждающихся людей
S.RNCH	ранчо	крупная ферма, основной специализацией которой является разведение крупного рогатого скота
S.RSD	запасный железнодорожный путь	короткая железная дорога, параллельная и примыкающая к главной железной дороге
S.RSGNL	железнодорожный сигнал	сигнал для передачи приказов и указаний, обеспечивающих безопасность движения поездов, маневровых работ
S.RSRT	курорт	местность с целебными природными свойствами, используемая для лечебных целей и для отдыха
S.RSTN	ж/д вокзал	здание или комплекс зданий для обслуживания пассажиров и размещения служб на железнодорожных станциях
S.RSTNQ	заброшенный вокзал	
S.RSTP	остановка поезда	пункт, место, установленные для посадки и высадки пассажиров электропоезда
S.RSTPQ	заброшенная остановка	
S.RUIN	руины	развалины какого-л. строения, сооружения
S.SCH	школа	учебное заведение, которое осуществляет общее образование и воспитание молодого поколения; здание, в котором помещается это заведение
S.SCHA	сельскохозяйственная школа	школа, в учебном плане которой сделан акцент на изучение сельскохозяйственных наук
S.SCHC	колледж	в Англии, США и некоторых других странах: высшее или среднее учебное заведение
S.SCHL	языковая школа	языковые учебные заведения
S.SCHM	военное училище	военное образовательное учреждение высшего и среднего профессионального образования
S.SCHN	военно-морское училище	военно-учебное заведение для подготовки офицеров военно-морского флота (ВМФ)
S.SCHT	техническое училище	школа, предоставляющая профессионально-техническое образование
S.SECP	центр подготовки к государственному экзамену	центры по подготовке к сдаче государственного экзамена
S.SHPF	овчарня	хлев, загон для овец
S.SHRN	рака	в христианской церкви: большой ларец (в виде гробницы или саркофага), в котором хранятся мощи святого
S.SHSE	склад	специальное помещение для хранения товаров, сырья, оборудования и т.п.
S.SLCE	шлюз	гидротехническое сооружение между водоёмами с различными уровнями воды, позволяющее переводить суда из одного водоёма в другой
S.SNTR	санаторий	лечебно-профилактическое учреждение для лечения и отдыха
S.SPA	спа	курорт с минеральным источником
S.SPLY	водослив	водосброс, осуществляющийся путём свободного перелива воды через гребень плотины
S.SQR	площадь	незастроенное, обрамлённое какими-л. зданиями, зелёными насаждениями место в пределах города или села, составляющее часть городского, сельского пространства
S.STBL	конюшня	помещение для содержания лошадей, обычно представляет собой постройку, разделённую на индивидуальные для каждой лошади секции, которые называются денниками
S.STDM	стадион	комплексное спортивное сооружение со специально оборудованными площадками для состязаний, тренировок, вспомогательными помещениями и трибунами для зрителей
S.STNB	научно-исследовательская база	помещение, которое используется в качестве базы для проведения различных научных исследований
S.STNC	пост береговой охраны	пункт, с которого вооруженные корабли ведут охрану береговой линии
S.STNE	испытательная станция	место проведения различного рода испытаний
S.STNF	лесничество	хозяйственные строения, в которых располагается управление лесным участком
S.STNI	контрольно-пропускной пункт	место досмотра вещей и обыска людей
S.STNM	метеорологическая станция	учреждение, которое проводит регулярные наблюдения за состоянием атмосферы
S.STNR	радиостанция	комплекс устройств для передачи информации посредством радиоволн и (или) её приёма
S.STNS	орбитальная станция	космический аппарат, предназначенный для долговременного пребывания людей на околоземной орбите с целью проведения научных исследований в условиях космического пространства, разведки, наблюдений за поверхностью и атмосферой планеты, астрономических наблюдений, и т.п.
S.STNW	китобойная станция	место забоя китов
S.STPS	крыльцо	пристройка перед входом в дом, состоящая из площадки и лестницы, иногда под навесом
S.SWT	очистное сооружение	комплекс инженерных сооружений в системе канализации населённого места или промышленного предприятия, предназначенный для очистки
S.THTR	театр	учреждение, организация, занимающиеся устройством представлений
S.TMB	могила	яма для погребения умершего
S.TMPL	храм	здание, предназначенное для совершения богослужений и религиозных обрядов
S.TNKD	макательная ванна для крупного рогатого скота	искусственный водоем со специальным химическим раствором; в этот водоем опускают крупный рогатый скот для профилактики от опасных заболеваний
S.TOWR	башня	высокое узкое архитектурное или инженерное сооружение (круглой, четырёхгранной или многогранной формы) различного назначения
S.TRANT	перевалочная база/станция пересадки	станция для перегрузки материалов с одного вида транспорта на другой и для пересадки пассажиров
S.TRIG	триангуляционный пост	опорный геодезический пункт, созданный методом триангуляции (геодезия)
S.TRMO	конечный пункт нефтепровода	нефтебаза или нефтеналивная станция в конце нефтепровода
S.TWO	биржа труда	учреждение, осуществляющее посредничество между предпринимателями и наёмными работниками
S.UNIP	подготовительные курсы	подготовительные курсы для поступления в высшее учебное заведение
S.UNIV	университет	высшее учебно-научное заведение с различными гуманитарными и естественно-математическими отделениями (факультетами)
S.USGE	представительство США в Панаме	учреждение, которое находится под контролем правительства США в Панаме
S.VETF	ветеринарная клиника	больница, где лечат животных
S.WALL	стена	вертикальная часть здания, служащая для поддержания перекрытий и разделения помещения на части
S.WALLA	античная стена	руины защитного сооружения, построенного из камня
S.WEIR	плотина	гидротехническое сооружение, перегораживающее водоток для подъёма воды в реке, создания водохранилища или электростанции
S.WHRF	пристань	специально оборудованное место, сооружение для причаливания и стоянки судов
S.WRCK	обломки разбитого судна	остатки кораблекрушения, выброшенные морем на берег
S.WTRW	водопроводная станция	система наносов и очистных сооружений, сквозь которые проходит вода, используемая в дальнейшем для питья и технических целей
S.ZNF	зона свободной торговли	территория, на которой не взимаются таможенные пошлины, налоги и сборы с пересекающих границу иностранных товаров
S.ZOO	зоопарк	зоологический парк, где содержат диких животных с целью их демонстрации
T.ASPH	асфальтовое озеро	небольшой бассейн, который вместо воды заполнен природным асфальтом
T.ATOL	атолл	коралловый остров кольцеобразной формы с мелководной лагуной внутри (преимущественно в Индийском и Тихом океанах)
T.BAR	бар	наносная мель у морских берегов (обычно в устье реки)
T.BCH	пляж	отлогий намывной берег, удобный для купания и принятия солнечных ванн
T.BCHS	пляжи	отлогие намывные берега, удобные для купания и принятия солнечных ванн
T.BDLD	бесплодная земля	неплодородная эродированная сильнопересечённая местность
T.BLDR	завалуненное поле	равнинная местность, покрытая большими углообразными валунами
T.BLHL	blowhole	a hole in coastal rock through which sea water is forced by a rising tide or waves and spurted through an outlet into the air
T.BLOW	развеянная дюна	небольшое углубление на песчаной местности, образовавшееся в результате эрозии
T.BNCH	выступ, имеющий вид ступени или террасы	выдающаяся вперед часть горного массива (обычно над водой), имеющая вид ступени или террасы
T.BUTE	крутой холм на равнине	небольшая  возвышенность округлой или овальной формы с крутым склоном
T.CAPE	мыс	часть суши, острым углом вдающаяся в водное пространство (море, озеро, реку)
T.CFT	расщелина	узкое ущелье в горах
T.CLDA	кальдера	котлообразная впадина с крутыми склонами и ровным дном, образовавшаяся вследствие провала вершины вулкана, а иногда и прилегающей к нему местности
T.CLF	утес	отвесная скала
T.CNYN	каньон	глубокая речная долина с очень крутыми или отвесными склонами
T.CONE	конус вулкана	рельеф канонической формы, образованный из вулканогенного материала и покрытый грязью
T.CRDR	коридор	узкое длинное пространство, проход, ограниченные с обеих сторон
T.CRQ	цирк	естественное чашеобразное углубление в привершинной части горы (обычно со скалистыми или покрытыми льдом, снегом стенами)
T.CRQS	цирки	естественные чашеобразные углубления в привершинной части горы (обычно со скалистыми или покрытыми льдом, снегом стенами)
T.CRTR	кратер	углубление на вершине вулкана, из которого при извержении выливается лава
T.CUET	куэста	наклонная равнина, круто обрезанная с одной стороны
T.DLTA	дельта реки	устье большой реки с его разветвлениями на отдельные рукава и прилегающая к нему суша
T.DPR	впадина	понижение земной поверхности в пределах суши, на дне океанов и морей
T.DSRT	пустыня	обширная засушливая область с небольшим количеством осадков, резкими колебаниями воздуха и почвы и скудной растительностью
T.DUNE	дюна	песчаный холм или их группа, образованные ветром на слабо закреплённых растительностью песчаных массивах
T.DVD	водораздел	возвышенная местность между бассейнами рек, разделяющая их
T.ERG	песчаная пустыня	тип пустынь с песчаной поверхностью
T.FAN	конус выноса	форма рельефа, имеющая вид слабовыпуклого полуконуса, образованного скоплением рыхлого обломочного материала (аллювия) в устьевой части временных водных потоков и небольших рек или при выходе их из гор на предгорные равнины или из ущелий в более широкую долину
T.FORD	брод	мелкое место во всю ширину реки, озера и т.п., удобное для перехода, переезда
T.FSR	расселина	глубокая трещина, узкое ущелье в горной породе, в земле
T.GAP	пропасть	крутой, глубокий обрыв, очень глубокая расселина, бездна
T.GRGE	ущелье	узкая крутосклонная долина (обычно в пределах горной страны), промытая рекой в твёрдых коренных породах
T.HDLD	возвышенный мыс	часть суши, острым углом вдающаяся в водное пространство (море, озеро, реку)
T.HLL	холм	небольшая отлогая горка, возвышенность округлой или овальной формы с пологими склонами
T.HLLS	холмы	небольшие отлогие горки, возвышенности округлой или овальной формы с пологими склонами
T.HMCK	торос	ледяная глыба, образовавшаяся при сжатии льдов на северных морях и реках
T.HMDA	каменистая пустыня	тип пустыни, развитой на слабовыветренных коренных породах плато низкогорий и мелкосопочника, покрытых щебнем и галькой (поверхность К. п. почти лишена почвенно-растительного покрова, животный компонент типично пустынный)
T.INTF	междуречье	местность, расположенная между двумя реками
T.ISL	остров	часть суши, со всех сторон окружённая водой
T.ISLET	islet	small island, bigger than rock, smaller than island.
T.ISLF	искусственный остров	искусственный остров (для разработки морских месторождений нефти и газа)
T.ISLM	мангровый остров	мангровое болото, окруженное водой
T.ISLS	острова	части суши, со всех сторон окружённые водой
T.ISLT	соединяющийся с материком остров	побережье острова, соединенное с материком посредством вырытого рва, траншеи или дамбы
T.ISLX	участок острова	
T.ISTH	перешеек	полоса суши, соединяющая два материка или материк с полуостровом и т.п., разделённые водой
T.KRST	карстовый район	ландшафт, образованный деятельностью подземных вод на участках суши, поверхность которых сложена растворимыми горными породами: известняками, гипсом, каменной солью и др.
T.LAVA	район застывшей лавы	an area of solidified lava
T.LEV	плотина	гидротехническое сооружение, перегораживающее водоток для подъёма воды в реке, создания водохранилища или электростанции
T.MESA	плоскогорье	обширная возвышенность с равнинной или холмистой поверхностью
T.MND	бугор	холм, горка
T.MRN	морена	скопление обломков горных пород, образуемое на границе передвижения и таяния ледников
T.MT	гора	Значительная возвышенность, поднимающаяся над окружающей местностью
T.MTS	горы	значительные возвышенности, поднимающиеся над окружающей местностью
T.NKM	шейка меандра	узкий участок суши между двумя краями излучины реки; самая узкая часть меандра реки
T.NTK	нунатак	изолированный скалистый пик, горный гребень или холм, выступающий над ледниковой поверхностью
T.NTKS	нунатаки	изолированные скалистые пики, горные гребни или холмы, выступающие над ледниковой поверхностью
T.PAN	котловина	большое углубление, впадина в земной поверхности с покатым спуском со всех сторон
T.PANS	котловины	большие углубления, впадины в земной поверхности с покатым спуском со всех сторон
T.PASS	дефиле	ущелье, узкий, тесный проход между возвышенностями или водными преградами (в котором можно остановить противника)
T.PEN	полуостров	часть суши, с трёх сторон омываемая водой, а четвёртой стороной примыкающая к материку или острову
T.PENX	участок полуострова	
T.PK	пик	остроконечная горная вершина или высшая точка горной вершины вообще
T.PKS	пики	остроконечные горные вершины
T.PLAT	плато	возвышенная равнина, ограниченная чётко выраженными уступами, крутыми склонами
T.PLATX	участок плато	
T.PLDR	польдер	осушенный участок моря или другого водоёма
T.PLN	равнина	обширный участок суши без значительных повышений и понижений поверхности
T.PLNX	участок равнины	
T.PROM	промонторий	выступ, мыс
T.PT	выступающая морская коса	длинная узкая отмель, идущая от берега, или низменный узкий мыс
T.PTS	выступающие морские косы	длинные узкие отмели, идущие от берега, или низменные узкие мысы
T.RDGB	гребень косы	песчаная гряда, находящаяся на суше или идущая параллельно пляжу
T.RDGE	горный хребет	ряд гор, тянущихся в одном направлении, горная цепь
T.REG	гаммада	каменистая пустыня
T.RK	скала	каменная глыба, утёс с крутыми склонами и острыми выступами
T.RKFL	камнепад	камни, низвергающиеся с гор лавиной
T.RKS	скалы	остроконечные горные вершины или высшие точки горной вершины вообще
T.SAND	район песков	территория, покрытая песками
T.SBED	высохшее речное русло	углубление в почве, по которому ранее текла вода
T.SCRP	откос	покатая поверхность горы, холма и т.п.; склон
T.SDL	седловина	продолговатая впадина, понижение между вершинами горного хребта или возвышенности
T.SHOR	побережье	полоса земной поверхности по обе стороны береговой линии моря, озера, водохранилища
T.SINK	карстовая воронка	отрицательная форма рельефа, замкнутая впадина чашеобразной, конической или другой формы, диаметром до 50 метров, глубиной до 15 (иногда до 200) метров
T.SLID	горка	естественное или специально сооруженное возвышение для спуска на лыжах, санках и т.п.
T.SLP	склон	наклонная поверхность, скат (горы, холма и т.п.)
T.SPIT	стрелка	узкий и длинный мыс при слиянии двух рек; песчаная коса, намытая прибоем
T.SPUR	отрог	ответвление основной горной цепи
T.TAL	скат, покрытый осыпью	пологий спуск, покрытый обломками горных пород, осыпающимися в результате выветривания
T.TRGD	впадина между дюнами	понижение земной поверхности в пределах суши, на дне океанов и морей, расположенное между двумя дюнами
T.TRR	терраса	горизонтальная или слегка наклонная площадка, образующая уступ на склоне местности, естественного происхождения или устроенная искусственно
T.UPLD	плоскогорье	обширная возвышенность с равнинной или холмистой поверхностью
T.VAL	долина	удлинённая впадина между гор или в холмистой местности; равнина вдоль речного русла
T.VALG	висячая долина	боковая долина, днище которой оканчивается выше днища главной долины
T.VALS	долины	удлинённые впадины между гор или в холмистой местности; равнины вдоль речного русла
T.VALX	участок долины	
T.VLC	вулкан	конусообразная гора с кратером на вершине, через который из недр земли извергаются огонь, лава, пепел, горячие газы, пары воды и обломки горных пород
U.APNU	береговой шельф	прибрежная мелководная зона океана (с глубинами до 200 м); материковая отмель
U.ARCU	дуга	территория, пространство, границы которого имеют форму изогнутой линии (например, дуга на юго-востоке Гавайского хребта)
U.ARRU	arrugado	an area of subdued corrugations off Baja California
U.BDLU	бордерленд	невысокий порог, отделяющий геосинклиналь от океана
U.BKSU	наносы	геологические образования, обязанные своим происхождением деятельности текучей воды; возвышенности на поверхности шельфа, не препятствующие судоходству
U.BNKU	нанос	геологическое образование, обязанное своим происхождением деятельности текучей воды; возвышенность на поверхности шельфа, не препятствующее судоходству
U.BSNU	впадина	понижение земной поверхности в пределах суши, на дне океанов и морей
U.CDAU	кордельера	горная цепь
U.CNSU	каньоны	глубокие речные долины с очень крутыми или отвесными склонами
U.CNYU	каньон	глубокая речная долина с очень крутыми или отвесными склонами
U.CRSU	материковое подножие	континентальное подножие, один из основных элементов подводной окраины материков; расположено между основанием материкового склона и внешней границей ложа океана
U.DEPU	пучина	водная глубь, морская бездна; глубокий провал в болоте, топь
U.EDGU	бровка шельфа	внешний край континентального шельфа
U.ESCU	утес	отвесная скала
U.FANU	конус выступа	аккумулятивная форма рельефа, образованная скоплением обломочных пород, вынесенных горными реками на предгорную равнину или в более плоскую широкую долину, где происходит резкое уменьшение живой силы потока
U.FLTU	низменность	равнина, расположенная не выше 200 м над уровнем моря; низменная территория, местность
U.FRZU	зона разломов земной коры	система крупных разломов (сбросов) и грабенов (рифтов)
U.FURU	желоб	длинная узкая впадина на дне океана или моря
U.GAPU	ущелье	узкая крутосклонная долина (обычно в пределах горной страны), промытая рекой в твёрдых коренных породах
U.GLYU	промоина	впадина в земле, промытая ливнем, образованная потоком воды
U.HLLU	холм	возвышенность, высота которой менее 500 метров
U.HLSU	холмы	возвышенности, высота которых менее 500 метров
U.HOLU	впадина	понижение земной поверхности в пределах суши, на дне океанов и морей
U.KNLU	возвышение морского дна	небольшая подводная возвышенность   округлой или овальной формы с пологими склонами
U.KNSU	возвышения морского дна	небольшие подводные возвышенности округлой или овальной формы с пологими склонами
U.LDGU	риф	надводные или подводные скалистые возвышения морского дна, опасные для судоходства
U.LEVU	насыпь	искусственное земляное возвышение, ограждающее каньон, речную долину или морской канал
U.MESU	столовая гора	гора с плоскими вершинами и более или менее крутыми, иногда ступенчатыми склонами
U.MNDU	могильный холм	низкий холмик округлой формы на месте погребения
U.MOTU	ров	длинное углубление, вырытое в земле
U.MTU	гора	значительная возвышенность, поднимающаяся над окружающей местностью
U.PKSU	пики	остроконечные горные вершины или высшие точки горной вершины вообще
U.PKU	пик	остроконечная горная вершина или высшая точка горной вершины вообще
U.PLNU	равнина	участок дна моря, океана без резких колебаний высот
U.PLTU	плато	возвышенная равнина, ограниченная чётко выраженными уступами, крутыми склонами
U.PNLU	шпиц	остроконечная скала
U.PRVU	провинция, физико-географическая	часть природной географической зоны в составе определенной физико-географической области; региональная единица физико-географического районирования. Физико-географические провинции выделяются по морфоструктурным особенностям рельефа и климату, а в горах - по характеру высотной поясности
U.RDGU	горный кряжи	цепи невысоких гор
U.RDSU	горный кряж	цепь невысоких гор
U.RFSU	рифы	надводные или подводные скалистые возвышения морского дна, опасные для судоходства
U.RFU	риф	надводные или подводные скалистые возвышения морского дна, опасные для судоходства
U.RISU	небольшое возвышение морского дна	участок морского дна,  возвышающийся над окружающим рельефом
U.SCNU	канал на дне океана	впадина на дне морского дна, с покатыми краями и защищенная с одной или двух сторон валом
U.SCSU	каналы на дне океана	впадины на дне морского дна с пологими склонами, защищенные с одной или двух сторон валом
U.SDLU	седловина подводной горной цепи	продолговатая впадина, понижение между вершинами подводного горного хребта или возвышенности
U.SHFU	шельф	прибрежная мелководная зона океана (с глубинами до 200 м); материковая отмель
U.SHLU	мелководье	участок (обычно прибрежный) реки, озера и т.п. с небольшой глубиной
U.SHSU	мелководья	участки (обычно прибрежные) реки, озера и т.п. с небольшой глубиной
U.SHVU	материковая отмель	относительно мелководная подводная равнина, прилегающая к берегам материков и генетически составляющая часть материковой платформы
U.SILU	порог	каменистое поперечное возвышение дна реки, нарушающее плавность её течения и затрудняющее судоходство
U.SLPU	откос	покатая поверхность горы, холма и т.п.; склон
U.SMSU	подводные горы	изолированные поднятия морского дна с относительной высотой более 500 м и четко выраженной конической или куполообразной одной или несколькими вершинами и крутыми склонами
U.SMU	подводная гора	изолированное поднятие морского дна с относительной высотой более 500 м и четко выраженной конической или куполообразной одной или несколькими вершинами и крутыми склонами
U.SPRU	хребет	ряд гор, тянущихся в одном направлении, горная цепь
U.TERU	терраса	горизонтальная или слегка наклонная площадка, образующая уступ на склоне местности, естественного происхождения или устроенная искусственно
U.TMSU	гайоты	плосковершинные подводные вулканические горы, встречающиеся одиночно или группами
U.TMTU	гайот	подводный плосковершинный вулкан
U.TNGU	коса	длинная узкая отмель, идущая от берега, или низменный узкий мыс
U.TRGU	впадина на дне океана с пологими склонами	углубление с пологими склонами  на дне океанов и морей
U.TRNU	впадина на дне океана с крутыми склонами	углубление с крутыми склонами на дне океанов и морей
U.VALU	лощина	овраг с пологими склонами
U.VLSU	лощины	овраги с пологими склонами
V.BUSH	кустарник	заросли куста
V.CULT	посевная площадь	площадь, предназначенная для возделывания многих с.-х. культур
V.FRST	лес	множество дикорастущих деревьев, расположенных на большом пространстве; пространство, обильно поросшее деревьями
V.FRSTF	окаменелый лес	значительное скопление древесных окаменелостей на небольшом участке
V.GRSLD	луг	пространство земли, покрытое травянистой растительностью; сенокосное, пастбищное угодье
V.GRVC	плантация кокосовых деревьев	большой участок земли, занятый кокосовыми деревьями
V.GRVO	плантация оливковых деревьев	большой участок земли, занятый оливковыми деревьями
V.GRVP	пальмовая роща	небольшой лесной участок, состоящий из пальмовых деревьев
V.GRVPN	сосновая роща	небольшой лесной участок, состоящий из сосен
V.HTH	верещатник	вересковые пустоши, тип растительности, представленный вечнозелёными кустарниками и кустарничками, преимущественно семейства вересковых, имеющих жёсткие узкие листья
V.MDW	луговина	небольшой луг, луг среди других угодий (лесных, пастбищных
V.OCH	фруктовый сад	участок земли, на котором выращивают фруктовые деревья
V.SCRB	кустарниковая заросль	густо разросшийся кустарник, массив трав, деревьев и т. п.
V.TREE	дерево	дерево (известное благодаря чему-л.), являющееся  достопримечательностью
V.TUND	тундра	тип растительности высоких широт Северного полушария Земли, характеризующийся развитием мохового и лишайникового покровов, наличием низкорослых кустарников и т.п.; природная зона с таким типом растительности
V.VIN	виноградник	участок, засаженный виноградом; виноградная плантация
V.VINS	виноградники	виноградные плантации
null	not available	
